skcmdlkm
kfdmvfok
fkdivkifm
fikovkofk
111111111
22222
0000000
lll